Lombardia,9439,1142,7304,17885,5865,3456,27206,70598
Emilia Romagna,2429,269,3692,6390,349,816,7555,28022
Veneto,1113,255,3276,4644,309,169,5122,57671
Piemonte,2118,308,1701,4127,10,283,442,12701
Marche,816,138,1277,2231,6,184,2421,6391
Toscana,706,215,1223,2144,42,91,2277,13264
Liguria,736,132,483,1351,143,171,1665,4995
Lazio,671,79,522,1272,58,53,1383,17845
Campania,243,99,524,866,41,29,936,4943
Friuli V.G.,163,47,528,738,89,47,874,6761
Trento,235,46,604,885,34,35,954,305
Bolzano,146,32,470,648,7,23,678,5718
Puglia,252,37,459,748,7,31,786,616
Sicilia,220,55,321,596,26,8,630,558
Abruzzo,218,49,272,539,15,33,587,3375
Umbria,97,35,368,500,5,16,521,3135
Valle d'Aosta,63,21,270,354,1,9,364,950
Sardegna,67,16,244,327,5,7,339,2402
Calabria,77,17,166,260,5,8,273,3666
Basilicata,13,10,58,81,,,81,643
Molise,24,7,21,52,7,7,66,532
TOTALE,19846,3009,23783,46638,7024,5476,59138,258402
