Lombardia,8258,1093,8019,17370,5050,3095,25515,66730
Emilia Romagna,2267,265,3129,5661,329,715,6705,24620
Veneto,942,249,3023,4214,257,146,4617,53642
Piemonte,1976,301,1229,3506,8,238,3752,10701
Marche,742,141,1114,1997,2,154,2153,5740
Toscana,664,202,1039,1905,35,72,2012,11909
Liguria,598,129,432,1159,125,152,1436,4304
Lazio,591,70,425,1086,54,50,119,13889
Campania,233,87,473,793,29,22,844,4448
Friuli V.G.,152,37,477,666,82,42,790,5955
Trento,233,39,448,720,34,28,782,2656
Bolzano,127,30,443,600,1,20,621,5179
Puglia,209,33,400,642,4,29,675,5617
Sicilia,206,48,204,458,26,6,490,4883
Abruzzo,185,44,265,494,13,22,529,3035
Umbria,92,29,326,447,5,10,462,2712
Valle d'Aosta,62,15,227,304,1,8,313,884
Sardegna,65,16,240,321,5,4,330,2297
Calabria,73,16,136,225,5,5,235,305
Molise,21,6,20,47,7,7,61,449
Basilicata,12,7,47,66,,,66,522
TOTALE,17708,2857,22116,42681,6072,4825,53578,233222
